000000000000000000000050000000000000000000000000000000000000000000000000000000000000000000000000000000000000000000000000000000000000000000000000000000000005000000000000000000000000
000000000000000000000000000000000000000000000000000000000000000000300000000000000000000000000000000000000000000000000000000000000000000000000000000000000000000000000000000000000000
000000000000000000000000000000000000000000000000000000000000000000000000000000000000000000000000000000000000000000000000000000000000000000000050000000000000000000000000000000000000
000000000000000000000000000000000000000000000000000000000000000000000000000000000000000000000000000000000000000000000000005000000000000000000015000000030000000000000000000000000000
000000000000000000000000000000000000000000000000000000000000000000000000000000000000000000000000000000000000000000000000000000000000000000000000500000000000000000000000000000000000
000000030000000000000020000000000000500000000000000000000000000000000000000000000000000000000000005000000000000000300000000000005000000000000000500000000000000000000000000000000000
000000000000000000000000000000000005050000000000000000000000000021111000000000000000000000005000000000000000000000000000000000000000000000000000500000000000000000000000000000000000
000000000000000000000000000000000050005000000000000000000000000000000000000000000000005000000000000000000000000000000000011100000000000111100000050000110000000000000000000000000000
000000000000000000000000000000000000000000000000000000001111300000000000000000000000000000000000000007000000000000000000000000000000000000000000000000000000044000000000000000000000
000000011211000000000010000000000400000400000000000000000000000050000000000000000000000000000007000007000003000012131000000000100004000000000000000000000000444000000000000000000000
000000000000000000000000000000004400000440000000000070000000001110000007000000000000000007000007000007000000000000000000000000000044000000000000000000000004444000000000000000000000
000000000000000607000006000000044400000444000008000070060000006000006007006000800007006007006007006007000600006000800000600000600444000060000060000060060044444000000000000000000000
990000000000000000000000000000444400000444400000000000000000000000000000000000000000000000000000000000000000000000000000000000004444000000000000000000000444444000040000000000000000
000000000000000000000000000000000000000000000000000000000000000000000000000000000000000000000000000000000000000000000000000000000000000000000000000000000000000000000000000000000000
000000000000000000000000000000000000000000000000000000000000000000000000000000000000000000000000000000000000000000000000000000000000000000000000000000000000000000000000000000000000
000000000000000000000000000000000000000000000000000000000000000000000000000000000000000000000000000000000000000000000000000000000000000000000000000000000000000000000000000000000000